NO ./path_to_the_north_texture
SO ./path_to_the_south_texture
WE ./path_to_the_west_texture
EA ./path_to_the_east_texture
F 220,100,0
C 225,30,0



11111       11111
10001111111110001
10000000000000001
10000000000000001
1000000N000000001
111111111111111011111111111111
        1000000000000000000001
	1000001111111111000111
	1000001111000000000111
	1000001111000000000111
	1000001111000000000111
	10000111111100000001111111111
	100000011111101101010011
	100010000101110001010101
	111111111111111111111111
