NO ./texture/japtext/japset0_0.xpm

SO ./texture/japtext/japset0_2.xpm


F 144,238,144

EA ./texture/japtext/japset0_1.xpm


WE ./texture/japtext/japset0_3.xpm

C 100,136,250




        1111111111111111111111111
        1000000000110000000000001
        1011000001110000000000001
        1001000000000000000000001
111111111011000001110000000000001
100000000011000001110111111111111
11110111111111011100000010001
11110111N11111011101010000001
11000000110101011100000010001
10000000000000000000000010001
10000000000000001101010010001
1100000111010101111101111000111
11110111 1110101 101111010001
11111111 1111111 111111111111
