NO = ./

WE = ./

SO = ./

F = 255, 240, 78

C = 75, 65, 98

EA = ./

	11111
      110000011
    11000000000111
   1100000E0000011
  11000000000000011
   110000000000011
    1100000000011
      110000011
        11111
