NO ./japtext/japset0_0.xpm

SO ./japtext/japset0_2.xpm


F 144,238,144

EA ./japtext/japset0_1.xpm


WE ./japtext/japset0_3.xpm

C 120,136,250

1111       11111
10001111111110001
10000000000000001
10000000000000001
1000000N000000001
11111111111111111

