NO ./texture/japtext/japset0_0.xpm

SO ./texture/japtext/japset0_2.xpm


F 144,238,144

EA ./texture/japtext/japset0_1.xpm


WE ./texture/japtext/japset0_3.xpm

C 120,136,250



11111        1111
10001111111110001
10000000000000001
10000000000000001
1000000N000000001
111111111111111011111111111111
        1000000000000000000001
        1000001111111111000111
        1000001111000000000111
        1000001111000000000111
        1000001111000000000111
        10000111111100000001111111111
        10000001111110110101001
        100010000101110001010101
        111111111111111111111111
