NO ./texture/japtext/japset0_0.xpm

SO ./texture/japtext/japset0_2.xpm


F 144,238,144

EA ./texture/japtext/japset0_1.xpm


WE ./texture/japtext/japset0_3.xpm

C 120,136,250

111111111
100000001
100000001
100000001
101110001
101100001
101110001
100N00001
100000001
111111111
