NO ./texture/japtext/japset0_0.xpm
SO ./texture/japtext/japset0_1.xpm
EA ./texture/japtext/japset0_2.xpm
WE ./texture/japtext/japset0_3.xpm

F 210, 56, 65
C 98, 123, 198

11111111111111111111111111111111111111111111111111111111
10000000000000000000000000000000000000000000000000000011
10000000000011111111111011111111111111111000000000000011
10000000000000111111110001111111111111110000000000000011
10000000000000111000000000010000001111000000000000000011
10000000000000111000000000010000001111000000000000000011          1111111111
10000000000000111000000000010000001111000000000000000011          1000000001
10000000000000111000000000010000001111000000000000000011          1000000001
1000000000000011100000000001000000111100000000000000001111111111111000000001
1000000000000011100000000001000000111100000000000000000000000000000000000001
1000000000000000000000000000000000000000000000000000000000000000000000000001
1000000000000000000000000000000000000000000000000000001111111111110000000001
10000000000000000000000000000000000000000000000000000011         10000000001
10000000000000111000000000010000001111000000000000000011         11110011111
10000000000000000000000000000000000000000000000000000011            1001
11111111111111111100111111111111111111000000111111111111           1001
                 1001                10000001                     1001
                 1001                100000001                   1001
                 1001                1000000001                 1001
                 1001                1000000001                1001
                 1001                 1000000001              1001
                 1001                  1000000001            1001
                 1001                   1000000001          1001
                 1001                    1000000001        1001
                 100111111111111111111111100000000111111111001
                 10000000000000000000000000000000000000000001
                 1000000000000N00000000000000000000000000011
                  10000000000000000000000000000000000000001
                  1000011111111100000011111111100000000101
                   100111111111100000001111111111000000101
                   1001        10000001         1000000111
                   1001        11000011         11000011
                   1111        1111111          1111111
