NO ./texture/japtext/japset0_0.xpm

SO ./texture/japtext/japset0_2.xpm


F 144,238,144

EA ./texture/japtext/japset0_1.xpm


WE ./texture/japtext/japset0_3.xpm

C 120,136,250

1111111111111111111111111
1000000000110000000000001
1011000001110000000000001
100100000000000000000000111111111
111111111011000001110000000000001
100000000011000001110111100111111
1111011111111101110000001000001
1111011111111101110101001000001
1100000011010101110000001000001
1000000000000000110000001000001
100W000000000000110101001000001
11000001110101011111011110000111
11110111 1110101 10111101000001
11111111 1111111 1111111111111

