NO ./texture/japtext/japset0_0.xpm

SO ./texture/japtext/japset0_2.xpm


F 144,238,144

EA ./texture/japtext/japset0_1.xpm


WE ./texture/japtext/japset0_3.xpm

C 120,136,250

1111111111111111
10100000W0000001
1111111111111111

