NO ./japtext/japset0_0.xpm

SO ./japtext/japset0_2.xpm


F 144,238,144

EA ./japtext/japset0_1.xpm


WE ./japtext/japset0_3.xpm

C 120,136,250

	11111
      110000011
    11000000000111
   1100000E0000011
  11000000000000011
   110000000000011
    1100000000011
      110000011
        11111
