NO ./japtext/japset0_0.xpm

SO ./japtext/japset0_2.xpm


F 144,238,144

EA ./japtext/japset0_1.xpm


WE ./japtext/japset0_3.xpm

C 120,136,250


111111111111111111
1010000000000000000001
1010000100000100000011111
1010000000010000000001111
1000E00000010000000001
1111111111111111111111
