NO ./japtext/japset0_0.xpm

SO ./japtext/japset0_2.xpm


F 144,238,144

EA ./japtext/japset0_1.xpm


WE ./japtext/japset0_3.xpm

C 120,136,250


1111111111111111111111111
1111111111111111111111111
