NO ./japtext/japset0_0.xpm

SO ./japtext/japset0_2.xpm


F 144,238,144

EA ./japtext/japset0_1.xpm


WE ./japtext/japset0_3.xpm

C 120,136,250

11111111111111111111111111
 11111100111111111100111111
 11110001111100111110001111
 11000001111000011110000011
 10000000111000011100000001
 1000N0000000000000000S0001
1000000000000000000000000001
1000000000000000000000000001
 10000000000000000000000001
 10000110001000010001100001
 11001111111100111111110011
 11100111111100111111100111
 11111111111111111111111111
