NO ./texture/basictext/facing_south.xpm    

SO ./texture/basictext/facing_north.xpm

EA./texture/basictext/facing_west.xpm               

WE ./texture/basictext/facing_east.xpm

F             6  ,    1       ,          6 


C 255,255,255 

        1111111111111111111111111
        1000000000110000000000001
        1011000001110000000000001
        1001000000000000000000001
111111111011000001110000000000001
100000000011000001110111111111111
11110111111111011100000010001
11110111111111011101010000001
11000000110101011100000010001
10000000000000000000000010001
10000000000000000000000010001
10000000000000000000000010001
10000000000000000000000010001
10000000000000000000000010001
10000000000000000000000010001
10000000000000000000000010001
10000000000000000000000010001
10000000000000000000000010001
10000000000000000000000010001
10000000000000000000000010001
10000000000000000000000010001
10000000000000000000000010001
10000000000000000000000010001
10000000000000000000000010001
10000000000000000000000010001
10000000000000000000000010001
10000000000000001101010010001
11000001110101011111011110N0111
10110111 1110101 101111010001
10111111 1111111 111111111111
10001111111111111111111111111
10000000000000000000000000001
11111111111111111111111110001
11111111111111111111110000001
10000000000000000000000000011
11000000110000000000000010001
1011111111111111111111111111111
100000000001         1110000001
100000000001        11110000001 
100000000001       110000000011
100000000001       1000000000011
100000000001111111110000000001111
100000000000000000000000000000001
100000000000000000000000000000001
100000000000000000000000000000001
111111111111111100000011111111111
               10000001
               10000001
               10000001
               10000001
               10000001
               10000001
               11111111

